11111111111111111111
10000000000000000001
1E111011101110111001
10101000100010001001
10001011100001001001
10001000100010001001
10001011101110001001
10000111111000000001
10000100P01C00010001
11111111111111111111