1111111111111111111111111
1P000000000C00000C0C00001
1011111111101111111111101
10100000000C0000C00000101
1C10111111111111111110101
10101000000C0000CC0010101
10101001111011111110101C1
1C101C01111E1111111000101
10101000CCCCCCCCC00010101
1010111111111111111110101
100000000CCCCCC0000000001
1111111111111111111111111
1111111111111111111111111
1111111111111111111111111
1111111111111111111111111
1111111111111111111111111
