11111111111111111111
1P000C000010000C0001
10111011101110101111
10001000100000100001
11101011111111101111
100000001000C0000001
10111011101010111101
10000000001000100001
11101111101111101011
1C000010000N00001E01
11111111111111111111
