1111111111111
1N0000P00CE01
1111111111111
