111111111111111111
1P000000000000N011
101111101111110101
1C000C000C000C0001
101111111101111101
100000000000000001
111111101111111101
1C000C000C000C00E1
111111111111111111