111111
100N11
1011C1
100EP1
111111
