1111111
1P0C0E1
1011101
1C00001
1011011
1111111
