1111111111111111111
1P00000000000000011
1011111011111111101
1C000C000C000C00011
1011111111011111101
1C000C000C000C00011
1011111111011111101
1N00000000000000E01
1111111111111111111
