111111111111
1P0000000001
101111111101
1C000C000C01
101101110101
100C00000C01
1111011111N1
1C00000000E1
111111111111
