1111111111111111111111111
1000000000000000000000001
1011101111101110111100001
1010101010101010100010001
1010101010101110111100001
1010101010101010101000001
1011101010101010100110001
1000000000000000000000001
10000000PC0000N0E00000001
1111111111111111111111111
